+-+-+-+-+-+-+-+-+-+-+-+-+-+-+-+-+
|                               |
+ + + + + + + + + + + + + + + + +
|                               |
+ + + + + + + + + + + + + + + + +
|                               |
+ + + + + + + + + + + + + + + + +
|                               |
+ + + + + + + + + + + + + + + + +
|                               |
+ + + + + + + + + + + + + + + + +
|                               |
+ + + + + + + + + + + + + + + + +
|                               |
+ + + + + + + +-+-+ + + + + + + +
|             |   |             |
+ + + + + + + + + + + + + + + + +
|                 |             |
+ + + + + + + +-+-+ + + + + + + +
|                               |
+-+-+-+-+-+-+-+-+ + + + + + + + +
|               |               |
+ + +-+-+-+-+-+ + + + + + + + + +
| |     |       |               |
+ +-+-+ +-+-+-+ + + + + + + + + +
| |           | |               |
+ + +-+-+-+ +-+ + + + + + + + + +
|         |     |               |
+ +-+ + + +-+ + + + + + + + + + +
| |   |   |   | |               |
+ + +-+ +-+ +-+ + + + + + + + + +
| |         |   |               |
+-+-+-+-+-+-+-+-+-+-+-+-+-+-+-+-+
